NO textures/bookshelf.xpm
SO textures/bookshelf.xpm
EA textures/bookshelf.xpm
WE textures/bookshelf.xpm

F 0,255,2147483648
C 255,0,255

11111111
10000001
1000E001
11000001
11111111
